# map height/width
8
8
# walls
1,1,1,1,1,3,1,1,
1,0,0,1,0,0,0,1,
1,0,0,4,0,2,0,1,
1,1,4,1,0,0,0,1,
2,0,0,0,0,0,0,1,
2,0,0,0,0,1,0,1,
2,0,0,0,0,0,0,1,
1,1,3,1,3,1,3,1,
