########
#.#....#
#.#....#
#.##...#
#......#
#....#.#
#......#
########
