# map height/width
8
8
# map
1,1,1,1,1,3,1,1,
1,0,0,1,0,0,0,1,
1,0,0,4,0,2,0,1,
1,1,4,1,0,0,0,1,
2,0,0,0,0,0,0,1,
2,0,0,0,0,1,0,1,
2,0,0,0,0,0,0,1,
1,1,3,1,3,1,3,1,
# floors
0,0,0,0,0,0,0,0,
0,0,0,0,1,1,0,0,
0,0,0,0,2,0,0,0,
0,0,0,0,0,0,0,0,
0,0,2,0,0,0,0,0,
0,0,0,0,0,0,0,0,
0,1,1,1,1,0,0,0,
0,0,0,0,0,0,0,0,
# ceiling
0,0,0,0,0,0,0,0,
0,0,0,0,0,0,0,0,
0,0,0,0,0,0,0,0,
0,0,0,0,0,0,1,0,
0,1,3,1,0,0,0,0,
0,0,0,0,0,0,0,0,
0,0,0,0,0,0,0,0,
0,0,0,0,0,0,0,0,
