9
9

1,1,1,1,1,1,1,1,1,
1,0,0,4,0,2,0,0,1,
1,0,0,2,0,4,0,0,1,
1,0,0,2,3,2,0,0,1,
1,0,0,2,0,2,0,0,1,
1,4,2,2,4,2,2,4,1,
1,0,0,0,0,2,0,0,1,
1,0,0,2,0,4,0,0,1,
1,1,1,1,1,1,1,1,1,

1,1,1,1,1,1,1,1,1,
1,0,0,0,0,0,0,0,1,
1,0,0,0,0,0,0,0,1,
1,0,0,2,3,2,0,0,1,
1,0,0,2,0,2,0,0,1,
1,0,0,2,0,2,0,0,1,
1,0,0,0,0,0,0,0,1,
1,0,0,0,0,0,0,0,1,
1,1,1,1,4,1,1,1,1,

1,1,1,1,1,1,1,1,1,
1,0,0,0,0,0,0,0,1,
1,0,0,0,0,0,0,0,1,
1,0,0,2,3,2,0,0,1,
1,0,0,2,0,2,0,0,1,
1,0,0,2,0,2,0,0,1,
1,0,0,0,0,0,0,0,1,
1,0,0,0,0,0,0,0,1,
1,1,1,1,4,1,1,1,1,
